+--+--+--+--+--+--+--+--+--+--+--+--+--+--+--+--+--+--+--+--+--+--+--+--+--+--+--+--+--+--+
S  |     |                 |     |              |     |     |     |     |           |     |
   |     |                 |     |              |     |     |     |     |           |     |
+  +  +  +  +--+--+--+--+  +  +  +  +--+--+  +  +--+  +  +  +  +  +  +--+  +--+--+  +  +--+
|     |           |           |  |     |     |     |     |  |  |  |        |        |     |
|     |           |           |  |     |     |     |     |  |  |  |        |        |     |
+  +--+--+  +--+  +--+--+--+  +  +--+  +  +--+--+  +--+--+  +--+  +--+--+--+  +  +--+--+  +
|  |        |     |           |  |     |  |        |        |     |     |     |  |     |  |
|  |        |     |           |  |     |  |        |        |     |     |     |  |     |  |
+  +  +--+--+  +--+  +--+--+--+  +--+--+  +  +--+  +  +--+--+  +--+  +  +  +--+  +  +  +  +
|  |        |     |     |     |           |     |     |     |  |  |  |  |     |     |  |  |
|  |        |     |     |     |           |     |     |     |  |  |  |  |     |     |  |  |
+--+--+--+  +--+--+--+  +--+  +--+--+--+--+  +  +--+--+--+  +  +  +  +  +--+  +--+--+--+  +
|     |     |        |     |        |        |  |           |  |     |     |  |           |
|     |     |        |     |        |        |  |           |  |     |     |  |           |
+  +  +--+--+  +--+  +--+  +--+--+  +  +--+--+  +  +--+--+--+  +  +--+--+  +  +--+  +--+--+
|  |  |        |  |  |        |     |     |  |     |     |     |  |        |     |  |     |
|  |  |        |  |  |        |     |     |  |     |     |     |  |        |     |  |     |
+  +  +  +--+  +  +  +  +  +--+  +--+--+  +  +--+--+  +  +  +  +  +  +--+--+  +  +  +  +  +
|  |     |     |  |     |        |        |  |        |  |  |  |  |           |     |  |  |
|  |     |     |  |     |        |        |  |        |  |  |  |  |           |     |  |  |
+  +--+--+  +--+  +--+--+--+  +--+  +--+--+  +--+  +--+  +  +  +  +--+--+--+--+--+--+--+  +
|  |     |     |        |        |  |     |     |  |  |  |  |     |        |           |  |
|  |     |     |        |        |  |     |     |  |  |  |  |     |        |           |  |
+  +  +  +--+--+  +--+  +  +--+  +  +  +--+--+  +  +  +  +  +--+--+  +--+  +  +--+--+  +  +
|  |  |        |  |     |     |  |              |  |  |        |     |     |        |     |
|  |  |        |  |     |     |  |              |  |  |        |     |     |        |     |
+  +  +--+--+  +--+  +--+--+  +  +--+--+--+--+--+  +  +--+  +  +  +--+  +--+--+--+  +  +--+
|     |     |        |     |  |  |        |     |     |     |  |  |  |        |     |  |  |
|     |     |        |     |  |  |        |     |     |     |  |  |  |        |     |  |  |
+--+--+  +--+--+--+--+  +  +  +--+  +--+  +  +  +--+--+  +--+  +  +  +--+--+  +  +--+  +  +
|     |           |     |  |  |     |     |  |  |  |     |        |           |  |  |     |
|     |           |     |  |  |     |     |  |  |  |     |        |           |  |  |     |
+  +--+--+  +--+  +  +  +  +  +  +--+  +--+  +  +  +  +--+  +--+--+--+--+--+--+  +  +--+--+
|     |        |  |  |  |  |     |        |  |     |  |  |  |     |           |     |     |
|     |        |  |  |  |  |     |        |  |     |  |  |  |     |           |     |     |
+--+  +  +--+  +  +  +  +--+--+  +  +--+--+  +--+  +  +  +  +  +  +  +--+--+  +  +--+  +  +
|  |  |  |     |     |           |        |  |     |  |  |     |  |     |     |     |  |  |
|  |  |  |     |     |           |        |  |     |  |  |     |  |     |     |     |  |  |
+  +  +  +  +--+--+--+--+  +--+--+--+--+  +  +  +--+  +  +--+--+  +  +  +  +--+--+  +  +  +
|  |     |           |     |  |           |  |        |           |  |  |           |  |  |
|  |     |           |     |  |           |  |        |           |  |  |           |  |  |
+  +--+--+--+--+--+  +  +--+  +  +--+--+--+  +--+--+--+  +--+--+--+--+  +--+--+--+--+  +  +
|  |     |     |     |        |           |  |     |  |        |     |  |              |  |
|  |     |     |     |        |           |  |     |  |        |     |  |              |  |
+  +  +  +--+  +  +--+--+--+--+--+--+  +--+  +  +  +  +  +--+  +  +  +  +  +--+--+--+--+  +
|     |  |     |  |        |        |        |  |     |  |        |     |  |        |     |
|     |  |     |  |        |        |        |  |     |  |        |     |  |        |     |
+  +--+  +  +  +  +  +--+  +  +--+  +--+--+--+--+  +--+--+  +  +--+--+--+  +  +--+  +  +--+
|  |  |     |  |  |     |  |  |     |     |     |     |     |              |     |        |
|  |  |     |  |  |     |  |  |     |     |     |     |     |              |     |        |
+  +  +--+--+  +  +--+  +--+  +  +--+--+  +  +  +--+  +  +--+--+--+--+  +--+--+  +--+--+--+
|  |        |  |     |        |              |  |  |     |  |        |        |  |        |
|  |        |  |     |        |              |  |  |     |  |        |        |  |        |
+  +  +--+  +--+--+  +--+--+  +  +--+--+--+--+  +  +--+--+  +  +--+  +--+--+  +  +--+--+  +
|  |     |        |        |  |  |        |  |     |        |  |  |     |     |  |     |  |
|  |     |        |        |  |  |        |  |     |        |  |  |     |     |  |     |  |
+  +--+  +--+--+  +--+--+  +  +--+  +--+  +  +  +--+  +--+--+  +  +--+  +--+--+  +  +  +  +
|  |  |        |        |     |     |  |  |  |     |     |     |     |  |        |  |  |  |
|  |  |        |        |     |     |  |  |  |     |     |     |     |  |        |  |  |  |
+  +  +  +--+--+--+  +  +--+--+  +--+  +  +  +--+  +--+  +  +  +--+  +  +  +--+--+  +  +  +
|  |     |           |     |  |  |     |        |  |  |     |  |  |        |        |  |  |
|  |     |           |     |  |  |     |        |  |  |     |  |  |        |        |  |  |
+  +--+--+  +--+--+--+--+  +  +  +  +--+--+  +  +  +  +--+--+  +  +--+  +--+--+  +--+  +  +
|        |  |              |  |     |        |     |           |  |  |           |        |
|        |  |              |  |     |        |     |           |  |  |           |        |
+  +  +  +  +--+--+  +--+--+  +  +--+  +--+--+--+--+--+--+--+--+  +  +--+--+--+--+  +  +--+
|  |  |  |        |     |     |  |     |  |        |  |     |     |                 |     |
|  |  |  |        |     |     |  |     |  |        |  |     |     |                 |     |
+  +  +--+--+  +  +--+  +  +--+--+  +--+  +  +--+  +  +  +  +  +--+  +--+--+--+--+--+--+  +
|  |     |     |     |     |        |     |     |        |           |     |     |        |
|  |     |     |     |     |        |     |     |        |           |     |     |        |
+--+--+  +--+--+--+  +--+--+  +--+  +  +--+--+  +--+--+--+--+  +--+--+  +--+  +  +  +--+--+
|     |  |           |  |     |     |  |  |     |        |     |              |  |  |     |
|     |  |           |  |     |     |  |  |     |        |     |              |  |  |     |
+  +--+  +  +--+--+--+  +  +--+  +--+  +  +  +--+--+--+  +  +--+  +--+  +--+--+  +  +--+  +
|  |     |                    |     |           |        |     |     |  |        |        |
|  |     |                    |     |           |        |     |     |  |        |        |
+  +  +--+--+  +  +--+  +--+--+--+--+--+--+--+  +  +--+--+--+  +  +--+  +  +--+--+--+--+  +
|  |           |  |  |        |                    |        |     |     |  |           |  |
|  |           |  |  |        |                    |        |     |     |  |           |  |
+  +--+--+--+--+  +  +--+--+  +  +--+--+--+--+  +--+  +--+  +--+--+  +--+  +--+--+--+  +  +
|        |     |     |     |  |     |     |     |  |  |  |           |     |     |     |  |
|        |     |     |     |  |     |     |     |  |  |  |           |     |     |     |  |
+--+--+  +--+  +--+--+  +  +--+--+  +  +  +--+--+  +  +  +--+--+  +--+  +--+  +  +  +--+  +
|     |                 |        |     |     |  |     |        |     |     |  |     |     |
|     |                 |        |     |     |  |     |        |     |     |  |     |     E
+  +  +--+--+  +--+--+--+--+--+  +--+--+--+  +  +--+--+--+  +  +--+--+--+  +  +--+--+  +  +
|  |           |                                |           |              |           |  +
|  |           |                                |           |              |           |  +
+--+--+--+--+--+--+--+--+--+--+--+--+--+--+--+--+--+--+--+--+--+--+--+--+--+--+--+--+--+--+
