+-+-+-+-+-+-+-+-+-+-+-+-+-+-+-+-+-+-+-+-+-+-+-+-+-+-+-+-+-+-+-+-+-+-+-+-+-+-+-+-+
S   |     |     |   |   |       |     |     |     |     |     |     |     |     |
+-+ + +-+ +-+ +-+ + +-+ +-+-+-+ +-+ +-+ +-+ + +-+ + +-+ + +-+ + +-+ + +-+ + +-+ +
|   | | |       | |       |   | |   |   |   | |     |   | |     |   | | |     | |
+ +-+ + +-+-+-+ + +-+-+ + + + + + +-+ +-+-+-+ +-+-+-+ +-+ + + +-+ +-+ + +-+ + + +
|     |   |     | | |   | | | |   |         |   |   | |   | | | |     | |   | | |
+-+ +-+-+ + +-+-+ + + +-+ + + + +-+ + +-+-+ + + + +-+ + +-+ + + +-+-+-+ + +-+ + +
|   |     | |     |   |     | |     | |   | | |   |   |   | | | |     |   |   | |
+ +-+ +-+-+-+ +-+-+-+-+ +-+-+ +-+-+-+ + +-+ + +-+ + +-+-+ + + + + +-+-+-+-+ +-+ +
|     |     |     | |   |   |       |   |   |   | |       | |   |         |   | |
+ +-+-+-+ + +-+-+ + + + + + +-+-+-+-+ +-+ +-+-+-+ + +-+-+-+ + +-+-+-+-+-+ +-+ + +
|   |   | |       |   | | | |         |   |   |   |     |   |     |     | |   | |
+ +-+ + + +-+-+-+-+ +-+ + + + +-+ +-+-+ +-+ + + +-+-+-+-+ +-+-+-+ + +-+-+ + +-+ +
| |   | | |   |   |   |   | |   |   |   |   |   |         |   | | |         |   |
+ + +-+ + +-+ + + +-+ +-+-+ +-+ +-+-+ + +-+-+ +-+ +-+-+-+-+ + + + +-+-+-+-+-+ +-+
| | |   |   |   |   | |     |   |   | | |     |   |   |   | | |   |           | |
+ + + +-+-+ +-+-+-+ + + +-+-+-+-+ + + +-+ +-+-+ +-+-+ + + + + +-+-+-+-+-+ +-+ + +
| | |   | |   |   |   |   |   |   | |     |     |     | |   |           | | |   |
+ + + + + +-+ + +-+-+-+-+ + + +-+ + + +-+-+ +-+-+ +-+-+ +-+-+-+-+-+-+-+ + + +-+ +
|   | | |     | |     |   | |     | |   | | |     |     |             |     |   |
+-+-+ + +-+ +-+ + +-+ + +-+ +-+-+ + +-+ + + + +-+-+ +-+-+ +-+-+-+-+ +-+-+ +-+ + +
| |   |     | |     |     |   |   |   | | |   |   |   | |   |     |       | | | |
+ + +-+-+-+-+ + +-+-+-+ + +-+ + +-+-+ + + +-+-+ + +-+ + +-+ + +-+ +-+-+-+-+ + + +
|   |     |   | |     | |   | | |   | | | |     |     |     |   |   |   |     | |
+-+-+-+-+ + +-+-+ +-+ + +-+ + + + + + + + +-+ +-+-+-+-+-+-+-+-+ +-+ +-+ + +-+-+ +
|         |       | | |   |   | | |     | |       |   |       | | |   |   |   | |
+ +-+-+-+-+-+-+-+-+ + +-+ +-+-+-+ +-+-+-+ + + +-+-+ + +-+-+-+ + + + + +-+-+ + + +
|   |           | | |     |       |     | | | |   | |     |   |   | | |     | | |
+-+ + +-+-+-+-+ + + +-+-+-+ +-+-+-+ +-+ + +-+ + + + +-+-+ + +-+-+-+-+ + +-+-+ + +
|   | | |   |   | |         |       |   |   | | |   | |   |   |     | |   |   | |
+ +-+ + + + +-+-+ + + +-+-+-+ +-+-+-+ +-+-+ + + +-+-+ + + + + + +-+ + +-+ +-+-+-+
|   |     |     | | |       |     | |   |   | | |   |   |   |     | |   |       |
+-+ +-+-+-+-+-+ + +-+-+-+ + + +-+ + +-+ +-+ +-+ + + +-+-+-+ +-+-+ +-+-+ +-+-+-+ +
| |     |   |   |   |     |   | | |     |     | | |     | | |   |   | |       | |
+ +-+ +-+ + + +-+-+ + +-+-+-+-+ + +-+-+-+ + + + + +-+-+ + + + +-+-+ + +-+ +-+-+ +
|   |     | | |   |           |   | |     | | | |   |       |   | | |   |       |
+ + +-+-+ + + + +-+-+-+-+-+-+ +-+-+ + +-+-+ + + +-+ +-+-+-+-+-+ + + + + + +-+-+ +
| | |     | | |   |   |     |       |   |   |     |         | | | | | |   |     |
+ +-+ +-+-+ + +-+ + + + +-+-+ +-+-+ +-+-+ +-+-+ + +-+-+-+-+ + + + + + +-+-+-+-+-+
|     |   |   |   | | |       |   | |     |   | |       | |   |     |   |   |   |
+-+ +-+-+ +-+ + + +-+ +-+ +-+-+ +-+ +-+ +-+-+ + +-+-+-+ + +-+ +-+ +-+ + + + +-+ +
| | | |   | |   |               |       |     |     | |   |     | | | |   | |   |
+ + + + +-+ +-+-+-+-+ +-+-+-+-+ + +-+-+-+ +-+-+-+-+ + +-+ + +-+-+ + + +-+-+ + + +
|   | |     | |     | |         | |   |   |     |   | |   |     |   | |   | | | |
+-+-+ +-+-+ + + +-+ + +-+-+-+ + + + + + +-+ +-+ + +-+ + +-+-+-+ +-+ + + + + + +-+
|   |     | | | |   |   | |   | |   | |   |   | | |   | | |   |   | | | |   |   |
+ + +-+-+ + + + +-+-+-+ + + +-+-+-+ +-+-+ + + +-+ + +-+ + + + +-+ +-+ + +-+-+-+ +
| |     | |             |   | |     |     | | |   | |     | |   |     | |     | |
+ +-+-+ + +-+-+ +-+-+-+-+-+-+ + +-+-+ + +-+-+ + +-+ +-+-+-+ + +-+-+-+-+ + +-+ + +
| |     |   | | |   |       | | |   | |       |   |       | |   |       |   |   |
+ + +-+-+-+ + + + + + +-+-+ + + + + + +-+-+-+ +-+ +-+-+-+ + +-+ +-+ +-+-+-+ + +-+
| | |     |   | | | | |     |   | | |     |       |   | |     | |   |       |   |
+ +-+ +-+ +-+ + + + + + +-+-+-+-+ + +-+ + +-+-+-+-+ + + +-+-+ +-+ +-+ +-+-+-+-+ +
|     | |   |     |   |   |       | |   |   |   |   |   | |   |   | |     |     |
+-+-+-+ +-+ +-+ +-+-+-+-+ + +-+-+-+ + +-+-+ + + + +-+-+ + + +-+ + + +-+-+ + +-+ +
|   |     |     |   |     |       | |   | |   | | |     |       |   |   | |   | |
+-+ + +-+ +-+-+-+ +-+ +-+-+-+-+-+-+ +-+ + +-+-+ + + +-+-+-+-+-+-+-+-+-+ + +-+ + +
|   | |   |     |     |   |       |     |   | | | |       |               | | | |
+ +-+ + +-+ +-+ +-+-+-+ + + +-+-+ +-+ +-+-+ + + + +-+-+-+ + +-+ +-+-+-+-+-+ + + +
| |   |   |   |   |     |   |   |           | | |       | |   |       |   |   | |
+ + + +-+ +-+ +-+-+ +-+-+-+-+-+ +-+-+ +-+-+-+ + +-+-+-+ + +-+ +-+ +-+ + + +-+-+ +
| | |   |   | |   |     |   |   |   |   |     |       | | |     |   |   |   |   |
+ + +-+ +-+ + + + +-+-+ + + + +-+-+ +-+ +-+ + +-+-+-+ + + + +-+ +-+-+-+-+-+ + +-+
| |   | |   | | |     | | | | |   |   |   | |   |       | | |   |         | | | |
+ +-+-+ + +-+ + +-+-+ + + + + + + +-+ +-+ + +-+ +-+ + +-+ +-+ +-+ +-+-+-+-+ + + +
| |     |   | |   |   |   | | | |     |   |   |   | |   | |   |         |   |   |
+ + +-+-+-+-+ +-+ + +-+-+ + + + +-+-+-+-+-+-+ +-+ + + +-+ + +-+-+-+-+-+ + +-+-+ +
|       |   |     |       |   |       |       | |   | |   | |         |   | |   |
+ + +-+ + + + +-+-+-+-+-+-+ +-+-+-+-+ + +-+-+-+ +-+ +-+ +-+ + +-+-+-+ +-+-+ + +-+
| |   |   | | |   | |       |   |   |   |   | | |   |   |   | |       |   | |   |
+-+-+ +-+-+ +-+ + + + +-+-+-+ + + + +-+-+ + + + +-+-+ +-+ +-+ +-+ + +-+ + + +-+ +
|   | | |   |   | |   |   |   |   | |     | | |     | |   | |   | | |   | |     |
+ + + + + +-+ +-+ + +-+ + + + +-+-+-+ + + + + +-+-+ + + +-+ + + + + +-+ + +-+-+-+
| | |   |     | |   |   |   |     |   | | |   |   |         | | | |     |       |
+ + + +-+-+-+-+ +-+ + +-+-+ + +-+-+ +-+ +-+-+ + + +-+ +-+-+-+ + + +-+-+-+-+ +-+ +
| |   |           | | |   | |         |   |   | |   | |     | | |     |   | |   |
+ +-+-+ +-+-+-+-+ + +-+ + + +-+-+-+-+-+-+ +-+-+ +-+ + + +-+ +-+ +-+-+ + + + +-+ +
|     | |   |   | |     |   |           |     |   |   | | |         |   | |   | |
+ +-+-+ + +-+ + + +-+-+-+-+-+ +-+-+-+-+ +-+-+ +-+ +-+-+ + +-+-+-+-+-+-+-+-+-+ + +
|       |     |   |           |               |         |                     | E
+-+-+-+-+-+-+-+-+-+-+-+-+-+-+-+-+-+-+-+-+-+-+-+-+-+-+-+-+-+-+-+-+-+-+-+-+-+-+-+-+
